@4/4/0/3/0/6/2/3/3/T/
#stage:0[tileset:1]
=000000000000000000000014,
|000000000000000000000014,
|000000000000000000000014,
|000000000000000000000014,
|000000000000000000000003,
|000000000000000000001414,
|000000000000000000000014,
|000000000000000000000014,
|000000000000000000000014;
#stage:1[tileset:1]
=001414141414141414141400,
|141414030303030303141414,
|141403030303030303031414,
|140303030303030303030314,
|140303030303030303030314,
|140303030303030303030314,
|140303030303030303030303,
|140303030303030303030303,
|141414030303030303141414;
M48(s=F)
#stage:2[tileset:1]
=000000000000000000000000,
|141414141414141414141414,
|140303030303030303030314,
|140303030303030303030314,
|140303140303030303030314,
|140303140303030303030314,
|030303140303030303030314,
|030303142222030303222214,
|141414141414030303141414;
B030303030303030303030303,
-030303030303030303030303,
-030303030303030303030303,
-030303030303030303030303,
-030303030303030303030303,
-030303030303030303030303,
-030303030303030303030303,
-030303030303030303030303,
-030303030303030303030303;
#stage:3[tileset:1]
=141414141414141414141414,
|140303030303030303030314,
|140303030303030303030314,
|140303030303030303030314,
|140303030303030303030314,
|140303030303030303030314,
|140303030303030303030314,
|140346030303030303030314,
|141414141414140303141414;
M86(S=3)
#stage:4[tileset:1]
=000000000000000000000014,
|000000000000000000000000,
|000000000000000000000000,
|000400040000040000000000,
|000400040004040400000000,
|000404040004450400000000,
|000400040004040400000000,
|000400040004000400000000,
|001414141414141414141414;
#stage:5[tileset:1]
=141414030303030303141414,
|001414030303030303141400,
|001414030303030303141400,
|001414030303030303141400,
|001414030303030303141400,
|001414030303030303141400,
|001414030303030303141400,
|001414030303030303141400,
|141414030303030303141414;
#stage:6[tileset:1]
=141414141414030303141414,
|140303030303030303030314,
|140303030303030303030314,
|140303030303030303030314,
|140303030303030303030314,
|140303030303030303030303,
|142222222222220303030303,
|141414141414141414141414,
|141414141414141414141414;
B030303030303030303030303,
-030303030303030303030303,
-030303030303030303030303,
-030303030303030303030303,
-030303030303030303030303,
-030303030303030303030303,
-030303030303030303030303,
-030303030303030303030303,
-030303030303030303030303;
#stage:7[tileset:1]
=141414141414141414141414,
|140303030303030303030314,
|140303030303030303030314,
|140303030303030303030314,
|140303030303030303030314,
|030303030303030303030314,
|030303030303030303030314,
|141414030303030303141414,
|140303030303030303030314;
M7(s=F)
M8(s=F)
#stage:8[tileset:1]
=001414141414141414141414,
|001403030303030303030314,
|001403030303030303030314,
|001403030303030303030314,
|001403030303030303030314,
|001403030303030303030314,
|001403030303030303030303,
|001403460303030303030303,
|001414141414141414141414;
M87(S=1)
B030303030303030303030303,
-030303030303030303030303,
-030303030303030303030303,
-030303030303030303030303,
-030303030303030303030303,
-030303030303030303030303,
-030303030303030303030303,
-030303030303030303030303,
-030303030303030303030303;
#stage:9[tileset:1]
=141414161616161616141414,
|141414161616161616141414,
|141403030303030303031414,
|141403030303030303031414,
|140303030303030303030314,
|140303030303030303030314,
|030303030303030303030303,
|030303030303030303030303,
|141403030303030303031414;
M3(S=1)
M4(S=1)
M5(S=1)
M6(S=1)
M7(S=1)
M8(S=1)
M15(S=2)
M16(S=2)
M17(S=2)
M18(S=2)
M19(S=2)
M20(S=2)
B030303030303030303030303,
-030303030303030303030303,
-030303030303030303030303,
-030303030303030303030303,
-030303030303030303030303,
-030303030303030303030303,
-030303030303030303030303,
-030303030303030303030303,
-030303030303030303030303;
#stage:10[tileset:1]
=141414141414141414141400,
|140303030303030303031400,
|140303030303030303031400,
|140303030303030303031400,
|140303030303030303031400,
|140303030303030303031400,
|030303030303030303031400,
|030303030303030346031400,
|141414141414141414141400;
M101(S=3)
M102(S=3)
M103(S=3)
B030303030303030303030303,
-030303030303030303030303,
-030303030303030303030303,
-030303030303030303030303,
-030303030303030303030303,
-030303030303030303030303,
-030303030303030303030303,
-030303030303030303030303,
-030303030303030303030303;
M92(S=2)
#stage:11[tileset:1]
=140303030303030303030314,
|140303030303030303030314,
|142222220303030303030314,
|140303030303030303030314,
|140303030303030303030314,
|140303030303222222222214,
|140303010303010303030113,
|130101010101010101010113,
|130101010101010101010113;
B030303030303030303030303,
-030303030303030303030303,
-030303030303030303030303,
-030303030303030303030303,
-030303030303030303030303,
-030303030303030303030303,
-030303030303030303030303,
-030303030303030303030303,
-030303030303030303030303;
#stage:12[tileset:1]
=000000000000000000000014,
|000000000000000000000014,
|000000000000000000000014,
|000000000000000000000014,
|000000000000000000000003,
|000000000000000000000003,
|000000000000000000000003,
|111111111111111111111114,
|131313121212121212121214;
M99(y=-32)
M1(y=-55)
M1(s=T)
M2(y=-55)
M2(s=T)
M3(y=-55)
M3(s=T)
M4(y=-55)
M4(s=T)
M5(y=-55)
M5(s=T)
M6(y=-55)
M6(s=T)
M7(y=-55)
M7(s=T)
M8(y=-55)
M8(s=T)
M9(y=-55)
M9(s=T)
M10(y=-55)
M10(s=T)
B000000000000000000000014,
-000000000000000000000014,
-000000000000000000000014,
-000000000000000000000014,
-000000000000000000000003,
-000000000000000000000003,
-000000000000000000000003,
-111111111111111111111114,
-131313131313131313131313;
#stage:13[tileset:1]
=141403030303030303031414,
|140303030303030303030314,
|140303030303030303030314,
|140303030303030303030314,
|030303030303030303030314,
|030303030303030303030314,
|030303030303030303030314,
|141414141414141414141414,
|141414141414141414141414;
M1(y=-48)
M10(y=-48)
B140300000000000000000314,
-000000000000000000000014,
-000000000000000000000014,
-000000000000000000000014,
-000000000000000000000003,
-000000000000000000000003,
-000000000000000000000003,
-111111111111111111111114,
-131313131313131313131313;
#stage:14[tileset:1]
=131313131313131313131313,
|131313010101010101011313,
|131301010101010101010113,
|131301010101010101010113,
|130101010101010101010113,
|130101010101010101010101,
|130101010101010101010101,
|130102010101010101020101,
|131314040404040404141313;
M5(S=3)
M6(S=3)
M7(S=3)
#stage:15[tileset:1]
=130101010101010101010113,
|130101010101010101010113,
|130101010101010101010113,
|132222220101010122222213,
|130101010101010101010113,
|010101010101010101010113,
|010101010101010101010113,
|010101010101010101011313,
|131313131313131313131313;
B030303030303030303030303,
-030303030303030303030303,
-030303030303030303030303,
-030303030303030303030303,
-030303030303030303030303,
-030303030303030303030303,
-030303030303030303030303,
-030303030303030303030303,
-030303030303030303030303;