@5/2/0/0/0/0/0/0/0/F/
#stage:0[tileset:1]
=000000000000000000000000,
|000000000000000000000000,
|000000000000000000000000,
|000000000000000000000000,
|000000000000000000000000,
|000000000000000000000000,
|000000000000000000000000,
|111111111111111111111111,
|121212121212121212121212;
B000000000000000000000000,
-000000000000000000000000,
-000000000000000000000000,
-000000000000000000000000,
-000000000000000000000000,
-000000000000000000000000,
-000000000000000000000000,
-000000000000000000000000,
-000000000000000000000000;
#stage:1[tileset:1]
=000000000000000000000000,
|000000000000000000000000,
|000000000000000000000000,
|000000000000000000000000,
|000000000000000000000000,
|000000000000000000000000,
|000000000000000000000000,
|111100000011110000001111,
|121200000012120000001212;
B000000000000000000000000,
-000000000000000000000000,
-000000000000000000000000,
-000000000000000000000000,
-000000000000000000000000,
-000000000000000000000000,
-000000000000000000000000,
-000000000000000000000000,
-000000000000000000000000;
#stage:2[tileset:1]
=000000000000000000000000,
|000000000000000000000000,
|000000000000000000000000,
|000000000000000000000000,
|000000000000000000000000,
|000000000000000000000000,
|000000000000000000000000,
|131300001313131313001313,
|131300001313131313001313;
M88(s=F)
M89(s=F)
M90(s=F)
M91(s=F)
M92(s=F)
M100(s=F)
M101(s=F)
M102(s=F)
M103(s=F)
M104(s=F)
B000000000000000000000000,
-000000000000000000000000,
-000000000000000000000000,
-000000000000000000000000,
-000000000000000000000000,
-000000000000000000000000,
-000000000000000000000000,
-000000000000000000000000,
-000000000000000000000000;
#stage:3[tileset:1]
=000000000000000000000000,
|000000000000000000000000,
|000000000000000000000000,
|000000000000000000000000,
|000000000000000000000000,
|000000000000000000000000,
|000000000000000000000000,
|161600001414141400001616,
|161600001414141400001616;
M88(k=T)
M89(k=T)
M90(k=T)
M91(k=T)
M100(k=T)
M101(k=T)
M102(k=T)
M103(k=T)
B000000000000000000000000,
-000000000000000000000000,
-000000000000000000000000,
-000000000000000000000000,
-000000000000000000000000,
-000000000000000000000000,
-000000000000000000000000,
-000000000000000000000000,
-000000000000000000000000;
#stage:4[tileset:1]
=000000000000000000000000,
|000000000000000000000000,
|000000000000000000000000,
|000000000000000000000000,
|000000000000000000000000,
|000000000000000000000000,
|000000000000000000000000,
|222200000022222200002222,
|000000000000000000000000;
M84(k=F)
M85(k=F)
M89(k=F)
M90(k=F)
M91(k=F)
M94(k=F)
M95(k=F)
B000000000000000000000000,
-000000000000000000000000,
-000000000000000000000000,
-000000000000000000000000,
-000000000000000000000000,
-000000000000000000000000,
-000000000000000000000000,
-000000000000000000000000,
-000000000000000000000000;
#stage:5[tileset:1]
=000000000000000000000000,
|000000000000000000000000,
|000000000000000000000000,
|130000000000000000000000,
|130000000000000000000000,
|130000000000000000000000,
|130000000000000000000000,
|130000000000000000000000,
|131313131313131313131313;
M36(f=-0.300000)
M48(f=-0.300000)
M60(f=-0.300000)
M72(f=-0.300000)
M84(f=-0.300000)
M96(f=-0.300000)
M97(f=-0.300000)
M98(f=-0.300000)
M99(f=-0.300000)
M100(f=-0.300000)
M101(f=-0.300000)
M102(f=-0.300000)
M103(f=-0.300000)
M104(f=-0.300000)
M105(f=-0.300000)
M106(f=-0.300000)
M107(f=-0.300000)
B000000000000000000000000,
-000000000000000000000000,
-000000000000000000000000,
-000000000000000000000000,
-000000000000000000000000,
-000000000000000000000000,
-000000000000000000000000,
-000000000000000000000000,
-000000000000000000000000;
#stage:6[tileset:1]
=000000000000000000000000,
|000000000000000000000000,
|000000000000000000000000,
|000000000000000000000000,
|000000000000000000000000,
|000000000000000000000000,
|000000000000000000000000,
|000000000000000000000013,
|131313131313131313131313;
M95(f=-0.300000)
M96(f=-0.300000)
M97(f=-0.300000)
M98(f=-0.300000)
M99(f=-0.300000)
M100(f=-0.300000)
M101(f=-0.300000)
M102(f=-0.300000)
M103(f=-0.300000)
M104(f=-0.300000)
M105(f=-0.300000)
M106(f=-0.300000)
M107(f=-0.300000)
B000000000000000000000000,
-000000000000000000000000,
-000000000000000000000000,
-000000000000000000000000,
-000000000000000000000000,
-000000000000000000000000,
-000000000000000000000000,
-000000000000000000000000,
-000000000000000000000000;
#stage:7[tileset:1]
=000000000000000000000000,
|000000000000000000000000,
|000000000000000000000000,
|000000000000000000000000,
|000000000000000000000000,
|000000000000000000000000,
|000000000000000000000000,
|000000000000000000000000,
|131313131313131313131313;
M96(f=-0.300000)
M97(f=-0.300000)
M98(f=-0.300000)
M99(f=-0.300000)
M100(f=-0.300000)
M101(f=-0.300000)
M102(f=-0.300000)
M103(f=-0.300000)
M104(f=-0.300000)
M105(f=-0.300000)
M106(f=-0.300000)
M107(f=-0.300000)
B000000000000000000000000,
-000000000000000000000000,
-000000000000000000000000,
-000000000000000000000000,
-000000000000000000000000,
-000000000000000000000000,
-000000000000000000000000,
-000000000000000000000000,
-000000000000000000000000;
#stage:8[tileset:1]
=000000000000000000000000,
|000000000000000000000000,
|000000000000000000000000,
|000000000000000000000000,
|000000000000000000000000,
|000000000000000000000000,
|000000000000000000000000,
|000000000000000000000000,
|131313131313131313131313;
M96(f=-0.300000)
M97(f=-0.300000)
M98(f=-0.300000)
M99(f=-0.300000)
M100(f=-0.300000)
M101(f=-0.300000)
M102(f=-0.300000)
M103(f=-0.300000)
M104(f=-0.300000)
M105(f=-0.300000)
M106(f=-0.300000)
M107(f=-0.300000)
B000000000000000000000000,
-000000000000000000000000,
-000000000000000000000000,
-000000000000000000000000,
-000000000000000000000000,
-000000000000000000000000,
-000000000000000000000000,
-000000000000000000000000,
-000000000000000000000000;
#stage:9[tileset:1]
=000000000000000000000000,
|000000000000000000000000,
|000000000000000000000000,
|000000000000000000000013,
|000000000000000000000013,
|000000000000000000000013,
|000000000000000000000013,
|000000000000000000000013,
|131313131313131313131313;
M47(f=-0.300000)
M59(f=-0.300000)
M71(f=-0.300000)
M83(f=-0.300000)
M95(f=-0.300000)
M96(f=-0.300000)
M97(f=-0.300000)
M98(f=-0.300000)
M99(f=-0.300000)
M100(f=-0.300000)
M101(f=-0.300000)
M102(f=-0.300000)
M103(f=-0.300000)
M104(f=-0.300000)
M105(f=-0.300000)
M106(f=-0.300000)
M107(f=-0.300000)
B000000000000000000000000,
-000000000000000000000000,
-000000000000000000000000,
-000000000000000000000000,
-000000000000000000000000,
-000000000000000000000000,
-000000000000000000000000,
-000000000000000000000000,
-000000000000000000000000;
