@4/2/1/1/4/7/3/0/2/F/
#stage:0[tileset:1]
=000000000000000000000000,
|000000000000000000001111,
|000000000000000000111212,
|111100000000001111121313,
|131211010101111212131313,
|131313010101131313131313,
|131313010101131313131313,
|131313010101131313131313,
|131313010101131313131313;
B;
#stage:1[tileset:1]
=131313130000000000000000,
|131313010000000000000000,
|131301000000000000000000,
|131301000000000000000000,
|131301000000000000000000,
|131301000000000000000000,
|131301000000000000001111,
|131301010000000011111213,
|131313010101011313131313;
M0(s=F)
M1(s=F)
M2(s=F)
M3(s=F)
M27(x=8)
M98(y=32)
M103(y=32)
B000000000000000000000014,
-000000000000000000000014,
-000000010000000000000014,
-000000000000000000000014,
-000000000000000000000003,
-000000000000000000000003,
-000000000000000000000003,
-111111111111111111111114,
-131301131313130113131313;
#stage:2[tileset:1]
=000000000000000000000000,
|000000000000000000000000,
|000000000013000000000000,
|000000000013130000000000,
|000000000013130000000000,
|000000000013130000000000,
|111111111113131111110000,
|131313131313131313131111,
|131313131313131313131313;
M81(y=32)
B000000000000000000000014,
-000000000000000000000014,
-000000000000000000000014,
-000000000000000000000014,
-000000000000000000000003,
-000000000000000000000003,
-000000000000000000000003,
-111111111111111111111114,
-131313131313131313131313;
#stage:3[tileset:1]
=000000000000000000000000,
|000000000000000000000000,
|000000000000000011111111,
|000000000000000000131313,
|000000000000000000000013,
|000000000000000000000013,
|000000000000000000001313,
|111113131313131313131313,
|131313131313131313131313;
B;
#stage:4[tileset:1]
=131313010101131313131313,
|010101010101010101010113,
|010101010101010101010113,
|011301011313130113010113,
|011301011301130113010113,
|011301011301130113010113,
|011313011313130113130145,
|111111111111111111111111,
|121212121212121212121212;
M69(s=T)
B;
#stage:5[tileset:1]
=131313010101011313131313,
|131313010101010113131313,
|131301010101010101131313,
|130101010101010101010113,
|130101010101010101010113,
|130101010101010101010101,
|131301010101010101010101,
|131313010101010101010101,
|131313131313131313131313;
B;
#stage:6[tileset:1]
=111111111113131111110000,
|131313131313131313131111,
|131313131313131313131313,
|131313131313131313131313,
|131313131301010113131313,
|010101010101010101010101,
|010101010101010101010101,
|011301010113130101011313,
|131322222213132222221313;
M52(y=-32)
M56(y=-32)
M85(y=32)
B000000000000000000000014,
-000000000000000000000014,
-000000000000000000000014,
-000000000000000000000014,
-000000000100000001000003,
-000000000000000000000003,
-000000000000000000000003,
-110111111111111111111114,
-131301010113130101011313;
#stage:7[tileset:1]
=111113131313131313131313,
|131313131313131313131313,
|131301010101010101131313,
|130101010101010101010113,
|130101010101440101010113,
|010101010101010101010113,
|010101010101010101011313,
|131313131313131313131313,
|131313131313131313131313;
B000000000000000000000014,
-000000000000000000000014,
-000000000000000000000014,
-000000000000000000000014,
-000000000000010000000003,
-000000000000000000000003,
-000000000000000000000003,
-111111111111111111111114,
-131313131313131313131313;
